//MAP CONVERTED BY dmm2tgm.py THIS HEADER COMMENT PREVENTS RECONVERSION, DO NOT REMOVE
"aM" = (
/obj/machinery/door/poddoor/ert,
/turf/open/floor/plasteel/patterned/brushed{
	planetary_atmos = 1
	},
/area/hangar)
"aY" = (
/obj/machinery/conveyor/auto/outpost,
/obj/effect/landmark/outpost/hangar_crate_spawner,
/turf/open/floor/plasteel/tech,
/area/hangar)
"bd" = (
/obj/structure/platform/industrial{
	dir = 10
	},
/turf/open/floor/plating/asteroid/sand/lit,
/area/hangar)
"ch" = (
/obj/structure/platform/industrial{
	dir = 8
	},
/obj/structure/flora/ausbushes/sparsegrass/hell{
	name = "sparse red grass"
	},
/turf/open/floor/plating/asteroid/sand/lit,
/area/hangar)
"cq" = (
/obj/effect/turf_decal/industrial/warning/cee,
/obj/machinery/light/floor/hangar,
/turf/open/floor/plasteel/tech{
	planetary_atmos = 1
	},
/area/hangar)
"cv" = (
/obj/structure/disposalpipe/trunk{
	dir = 4
	},
/obj/machinery/conveyor/auto/outpost{
	dir = 1
	},
/obj/structure/disposaloutlet{
	dir = 1
	},
/turf/open/floor/plasteel/tech,
/area/hangar)
"cG" = (
/obj/structure/sign/departments/cargo,
/turf/closed/indestructible/reinforced,
/area/hangar)
"dc" = (
/obj/effect/turf_decal/industrial/warning/cee{
	dir = 1
	},
/obj/machinery/light/floor/hangar,
/turf/open/floor/plasteel/tech,
/area/hangar)
"dx" = (
/obj/effect/turf_decal/arrows{
	dir = 1
	},
/turf/open/floor/plasteel/tech{
	planetary_atmos = 1
	},
/area/hangar)
"dL" = (
/obj/structure/flora/ausbushes/sparsegrass/hell{
	name = "sparse red grass"
	},
/turf/open/floor/plating/asteroid/sand/lit,
/area/hangar)
"dS" = (
/obj/effect/turf_decal/industrial/warning{
	dir = 1
	},
/obj/effect/turf_decal/industrial/warning,
/obj/machinery/light/floor/hangar,
/turf/open/floor/plasteel/tech,
/area/hangar)
"eH" = (
/turf/closed/indestructible/reinforced,
/area/hangar)
"fn" = (
/obj/structure/platform/industrial{
	dir = 6
	},
/obj/structure/flora/ausbushes/sparsegrass/hell{
	name = "sparse red grass"
	},
/turf/open/floor/plating/asteroid/sand/lit,
/area/hangar)
"fv" = (
/obj/structure/platform/industrial{
	dir = 1
	},
/obj/structure/flora/ausbushes/sparsegrass/hell{
	name = "sparse red grass"
	},
/turf/open/floor/plating/asteroid/sand/lit,
/area/hangar)
"fS" = (
/obj/effect/turf_decal/industrial/warning/corner{
	dir = 4
	},
/turf/open/floor/plasteel/tech,
/area/hangar)
"ga" = (
/obj/effect/turf_decal/techfloor{
	dir = 9
	},
/turf/open/floor/plasteel/tech/grid{
	planetary_atmos = 1
	},
/area/hangar)
"gc" = (
/obj/effect/turf_decal/siding/wideplating/corner{
	dir = 1;
	color = "#CEB689"
	},
/obj/effect/turf_decal/siding/wideplating/corner{
	dir = 8;
	color = "#CEB689"
	},
/turf/open/floor/plasteel,
/area/hangar)
"gg" = (
/obj/structure/platform/industrial/corner{
	dir = 1
	},
/turf/open/floor/plating/asteroid/sand/lit,
/area/hangar)
"gA" = (
/obj/effect/turf_decal/industrial/warning{
	dir = 1
	},
/obj/effect/turf_decal/industrial/warning{
	dir = 3
	},
/obj/machinery/light/floor/hangar,
/turf/open/floor/plasteel/tech,
/area/hangar)
"gP" = (
/obj/effect/turf_decal/siding/wideplating{
	dir = 6;
	color = "#CEB689"
	},
/obj/effect/turf_decal/corner/opaque/yellow,
/obj/effect/turf_decal/corner/opaque/yellow{
	dir = 4
	},
/obj/effect/turf_decal/corner/opaque/yellow{
	dir = 8
	},
/obj/structure/chair/bench/olive/directional/north,
/obj/machinery/light/directional/south,
/turf/open/floor/plasteel,
/area/hangar)
"gX" = (
/obj/structure/plasticflaps/outpost,
/obj/machinery/conveyor/auto/outpost{
	dir = 8
	},
/turf/open/floor/plasteel/tech,
/area/hangar)
"hf" = (
/obj/structure/platform/industrial{
	dir = 4
	},
/turf/open/floor/plating/asteroid/sand/lit,
/area/hangar)
"hm" = (
/obj/effect/turf_decal/siding/wideplating{
	dir = 8;
	color = "#CEB689"
	},
/obj/effect/turf_decal/corner/opaque/yellow{
	dir = 1
	},
/obj/effect/turf_decal/corner/opaque/yellow{
	dir = 8
	},
/turf/open/floor/plasteel,
/area/hangar)
"hT" = (
/obj/structure/platform/industrial,
/obj/structure/flora/ausbushes/sparsegrass/hell{
	name = "sparse red grass"
	},
/turf/open/floor/plating/asteroid/sand/lit,
/area/hangar)
"iZ" = (
/turf/open/floor/hangar,
/area/hangar)
"jd" = (
/obj/effect/turf_decal/techfloor{
	dir = 6
	},
/turf/open/floor/plasteel/tech/grid{
	planetary_atmos = 1
	},
/area/hangar)
"ks" = (
/turf/open/floor/plasteel/stairs{
	icon = 'icons/obj/stairs.dmi';
	dir = 1
	},
/area/hangar)
"lT" = (
/obj/effect/turf_decal/industrial/warning{
	dir = 3
	},
/turf/open/floor/plasteel/tech,
/area/hangar)
"mG" = (
/obj/structure/chair,
/turf/open/floor/plasteel/tech,
/area/hangar)
"nV" = (
/obj/machinery/conveyor/auto/outpost{
	dir = 10
	},
/turf/open/floor/plasteel/tech,
/area/hangar)
"oQ" = (
/obj/effect/turf_decal/industrial/warning/corner{
	dir = 8
	},
/turf/open/floor/plasteel/tech,
/area/hangar)
"pK" = (
/obj/effect/landmark/outpost/elevator{
	shaft = "1"
	},
/turf/open/floor/plasteel/elevatorshaft{
	planetary_atmos = 1
	},
/area/hangar)
"pL" = (
/obj/effect/turf_decal/industrial/outline{
	color = "#C3630C"
	},
/turf/open/floor/plasteel/tech,
/area/hangar)
"pO" = (
/obj/machinery/door/airlock/grunge{
	dir = 4
	},
/obj/effect/landmark/outpost/elevator_machine{
	shaft = "1"
	},
/obj/effect/turf_decal/industrial/traffic{
	dir = 4
	},
/obj/effect/turf_decal/industrial/traffic{
	dir = 8
	},
/turf/open/floor/plasteel/tech/techmaint,
/area/hangar)
"pT" = (
/obj/effect/turf_decal/siding/wideplating{
	dir = 5;
	color = "#CEB689"
	},
/obj/effect/turf_decal/corner/opaque/yellow{
	dir = 4
	},
/obj/effect/turf_decal/corner/opaque/yellow{
	dir = 1
	},
/obj/effect/turf_decal/corner/opaque/yellow{
	dir = 4
	},
/obj/effect/turf_decal/corner/opaque/yellow,
/obj/structure/chair/bench/olive/directional/south,
/obj/machinery/light/directional/north,
/turf/open/floor/plasteel,
/area/hangar)
"qq" = (
/obj/effect/turf_decal/siding/wideplating{
	color = "#CEB689"
	},
/obj/effect/turf_decal/corner/opaque/yellow,
/obj/effect/turf_decal/corner/opaque/yellow{
	dir = 8
	},
/obj/effect/spawner/random/vending/snack,
/turf/open/floor/plasteel,
/area/hangar)
"qD" = (
/turf/open/space/basic,
/area/hangar)
"sb" = (
/turf/closed/indestructible/rock,
/area/hangar)
"sX" = (
/obj/effect/turf_decal/siding/wideplating{
	dir = 9;
	color = "#CEB689"
	},
/obj/effect/turf_decal/corner/opaque/yellow{
	dir = 1
	},
/obj/effect/turf_decal/corner/opaque/yellow{
	dir = 8
	},
/obj/effect/turf_decal/corner/opaque/yellow{
	dir = 1
	},
/obj/effect/turf_decal/corner/opaque/yellow{
	dir = 4
	},
/obj/structure/chair/bench/olive/directional/south,
/obj/machinery/light/directional/north,
/turf/open/floor/plasteel,
/area/hangar)
"uE" = (
/obj/effect/turf_decal/industrial/warning/cee{
	dir = 8
	},
/obj/machinery/light/floor/hangar,
/turf/open/floor/plasteel/tech,
/area/hangar)
"vi" = (
/obj/machinery/conveyor/auto/outpost{
	dir = 8
	},
/turf/open/floor/plasteel/tech,
/area/hangar)
"vO" = (
/obj/structure/platform/industrial{
	dir = 8
	},
/turf/open/floor/plating/asteroid/sand/lit,
/area/hangar)
"wg" = (
/obj/effect/turf_decal/siding/wideplating/corner{
	dir = 8;
	color = "#CEB689"
	},
/obj/effect/turf_decal/siding/wideplating/corner{
	dir = 1;
	color = "#CEB689"
	},
/turf/open/floor/plasteel,
/area/hangar)
"ww" = (
/obj/effect/turf_decal/industrial/traffic{
	dir = 4
	},
/obj/effect/turf_decal/industrial/traffic{
	dir = 8
	},
/obj/effect/turf_decal/industrial/stand_clear{
	dir = 8
	},
/obj/machinery/door/airlock/grunge{
	dir = 4
	},
/obj/effect/landmark/outpost/elevator_machine{
	shaft = "1"
	},
/turf/open/floor/plasteel/tech/techmaint,
/area/hangar)
"wz" = (
/obj/effect/turf_decal/industrial/warning/cee,
/obj/machinery/light/floor/hangar,
/turf/open/floor/plasteel/tech,
/area/hangar)
"wD" = (
/obj/machinery/disposal/deliveryChute{
	dir = 1
	},
/obj/structure/disposalpipe/trunk{
	dir = 8
	},
/turf/open/floor/plasteel/tech,
/area/hangar)
"wO" = (
/obj/effect/turf_decal/siding/wideplating/corner{
	color = "#CEB689"
	},
/turf/open/floor/plasteel,
/area/hangar)
"wS" = (
/obj/effect/turf_decal/industrial/warning{
	dir = 1
	},
/obj/effect/turf_decal/industrial/warning,
/turf/open/floor/plasteel/tech,
/area/hangar)
"xD" = (
/obj/structure/catwalk/over/plated_catwalk/dark,
/turf/open/floor/hangar,
/area/hangar)
"xT" = (
/obj/effect/turf_decal/industrial/warning{
	dir = 1
	},
/turf/open/floor/plasteel/tech,
/area/hangar)
"yl" = (
/obj/machinery/door/airlock{
	dir = 4
	},
/obj/effect/turf_decal/industrial/warning/fulltile,
/obj/machinery/door/firedoor/border_only{
	dir = 8
	},
/obj/machinery/door/firedoor/border_only{
	dir = 4
	},
/turf/open/space/basic,
/area/hangar)
"yD" = (
/turf/open/floor/plasteel/stairs{
	icon = 'icons/obj/stairs.dmi';
	dir = 4
	},
/area/hangar)
"yQ" = (
/obj/effect/turf_decal/siding/wideplating{
	dir = 4;
	color = "#CEB689"
	},
/obj/effect/turf_decal/corner/opaque/yellow{
	dir = 4
	},
/obj/effect/turf_decal/corner/opaque/yellow,
/turf/open/floor/plasteel,
/area/hangar)
"yW" = (
/obj/structure/platform/industrial/corner{
	dir = 4
	},
/turf/open/floor/plating/asteroid/sand/lit,
/area/hangar)
"zi" = (
/obj/machinery/door/poddoor/ert,
/turf/open/floor/plasteel/elevatorshaft{
	planetary_atmos = 1
	},
/area/hangar)
"Bv" = (
/obj/effect/turf_decal/industrial/warning/cee{
	dir = 1
	},
/obj/machinery/light/floor/hangar,
/turf/open/floor/plasteel/tech{
	planetary_atmos = 1
	},
/area/hangar)
"Dv" = (
/obj/effect/landmark/outpost/hangar_numbers,
/turf/open/floor/plasteel,
/area/hangar)
"DE" = (
/obj/effect/turf_decal/techfloor{
	dir = 5
	},
/turf/open/floor/plasteel/tech/grid{
	planetary_atmos = 1
	},
/area/hangar)
"En" = (
/obj/effect/turf_decal/siding/wideplating{
	dir = 1;
	color = "#CEB689"
	},
/obj/effect/turf_decal/corner/opaque/yellow{
	dir = 4
	},
/obj/effect/turf_decal/corner/opaque/yellow{
	dir = 1
	},
/obj/effect/spawner/random/vending/cola,
/turf/open/floor/plasteel,
/area/hangar)
"Ep" = (
/obj/effect/turf_decal/siding/wideplating/corner{
	dir = 4;
	color = "#CEB689"
	},
/turf/open/floor/plasteel,
/area/hangar)
"EG" = (
/obj/effect/turf_decal/industrial/warning{
	dir = 1
	},
/obj/effect/turf_decal/industrial/warning{
	dir = 3
	},
/turf/open/floor/plasteel/tech,
/area/hangar)
"EH" = (
/obj/structure/catwalk/over/plated_catwalk/dark,
/turf/open/floor/plating,
/area/hangar)
"Fj" = (
/obj/effect/decal/fakelattice,
/turf/open/floor/plasteel/elevatorshaft{
	planetary_atmos = 1
	},
/area/hangar)
"FF" = (
/obj/effect/turf_decal/industrial/warning/cee{
	dir = 4
	},
/obj/machinery/light/floor/hangar,
/turf/open/floor/plasteel/tech,
/area/hangar)
"Hl" = (
/obj/structure/platform/industrial{
	dir = 1
	},
/turf/open/floor/plating/asteroid/sand/lit,
/area/hangar)
"HC" = (
/turf/open/floor/plasteel,
/area/hangar)
"Ji" = (
/obj/machinery/light/floor/hangar,
/obj/effect/turf_decal/industrial/warning/cee{
	dir = 8
	},
/turf/open/floor/plasteel/tech,
/area/hangar)
"JB" = (
/obj/effect/turf_decal/trimline/opaque/yellow/warning{
	dir = 8
	},
/turf/open/floor/plasteel/tech{
	planetary_atmos = 1
	},
/area/hangar)
"JJ" = (
/turf/open/floor/plasteel/tech{
	planetary_atmos = 1
	},
/area/hangar)
"JL" = (
/obj/structure/flora/tree/cactus,
/turf/open/floor/plating/asteroid/sand/lit,
/area/hangar)
"JT" = (
/obj/machinery/conveyor/auto/outpost{
	dir = 6;
	verted = -1
	},
/turf/open/floor/plasteel/tech,
/area/hangar)
"JZ" = (
/turf/open/floor/plating/asteroid/sand/lit,
/area/hangar)
"Kb" = (
/turf/open/floor/plasteel/elevatorshaft{
	planetary_atmos = 1
	},
/area/hangar)
"Ku" = (
/obj/effect/turf_decal/industrial/hatch/orange,
/turf/open/floor/plasteel/tech,
/area/hangar)
"KF" = (
/turf/open/floor/plasteel/stairs{
	icon = 'icons/obj/stairs.dmi'
	},
/area/hangar)
"KW" = (
/obj/effect/turf_decal/siding/wideplating{
	dir = 8;
	color = "#CEB689"
	},
/obj/effect/turf_decal/corner/opaque/yellow{
	dir = 8
	},
/obj/effect/turf_decal/corner/opaque/yellow{
	dir = 1
	},
/obj/effect/turf_decal/corner/opaque/yellow{
	dir = 1
	},
/turf/open/floor/plasteel,
/area/hangar)
"Li" = (
/obj/effect/turf_decal/industrial/loading/stripes{
	color = "#C3630C"
	},
/obj/effect/turf_decal/arrows,
/turf/open/floor/plasteel/tech,
/area/hangar)
"LK" = (
/obj/machinery/door/poddoor/multi_tile/four_tile_ver,
/turf/closed/indestructible/reinforced,
/area/hangar)
"Nz" = (
/obj/effect/turf_decal/industrial/warning/corner{
	dir = 1
	},
/turf/open/floor/plasteel/tech,
/area/hangar)
"Om" = (
/obj/structure/platform/industrial,
/turf/open/floor/plating/asteroid/sand/lit,
/area/hangar)
"PY" = (
/obj/effect/turf_decal/industrial/warning{
	dir = 4
	},
/obj/effect/turf_decal/industrial/warning{
	dir = 8
	},
/turf/open/floor/plasteel/tech,
/area/hangar)
"QG" = (
/turf/open/floor/plasteel/tech,
/area/hangar)
"QM" = (
/obj/structure/disposalpipe/segment{
	dir = 4
	},
/turf/closed/indestructible/reinforced,
/area/hangar)
"Sq" = (
/obj/structure/chair{
	dir = 4
	},
/turf/open/floor/plasteel/tech,
/area/hangar)
"Tv" = (
/obj/effect/turf_decal/industrial/warning{
	dir = 8
	},
/turf/open/floor/plasteel/tech,
/area/hangar)
"TO" = (
/obj/effect/turf_decal/techfloor{
	dir = 10
	},
/turf/open/floor/plasteel/tech/grid{
	planetary_atmos = 1
	},
/area/hangar)
"Um" = (
/obj/effect/landmark/outpost/hangar_dock,
/turf/open/floor/hangar,
/area/hangar)
"Vv" = (
/obj/effect/turf_decal/industrial/warning/corner,
/turf/open/floor/plasteel/tech,
/area/hangar)
"VT" = (
/obj/effect/turf_decal/industrial/warning{
	dir = 8
	},
/obj/effect/turf_decal/industrial/warning{
	dir = 4
	},
/turf/open/floor/plasteel/tech{
	planetary_atmos = 1
	},
/area/hangar)
"VV" = (
/obj/structure/marker_beacon{
	picked_color = "Teal"
	},
/turf/open/floor/hangar,
/area/hangar)
"Wg" = (
/obj/effect/turf_decal/industrial/warning{
	dir = 4
	},
/obj/effect/turf_decal/industrial/warning{
	dir = 8
	},
/obj/machinery/light/floor/hangar,
/turf/open/floor/plasteel/tech,
/area/hangar)
"WY" = (
/obj/machinery/light/floor/hangar,
/turf/open/floor/plasteel/tech{
	planetary_atmos = 1
	},
/area/hangar)
"XS" = (
/obj/machinery/door/poddoor/multi_tile/four_tile_ver,
/turf/open/space/basic,
/area/hangar)
"Yb" = (
/obj/effect/landmark/outpost/elevator_machine{
	shaft = "1"
	},
/obj/machinery/elevator_call_button{
	dir = 8;
	pixel_x = 25
	},
/obj/effect/turf_decal/siding/wideplating{
	dir = 4;
	color = "#CEB689"
	},
/obj/effect/turf_decal/corner/opaque/yellow{
	dir = 4
	},
/obj/effect/turf_decal/corner/opaque/yellow,
/turf/open/floor/plasteel,
/area/hangar)
"Yj" = (
/obj/structure/chair/bench/olive/directional/north,
/obj/effect/turf_decal/siding/wideplating{
	dir = 10;
	color = "#CEB689"
	},
/obj/effect/turf_decal/corner/opaque/yellow,
/obj/effect/turf_decal/corner/opaque/yellow{
	dir = 8
	},
/obj/effect/turf_decal/corner/opaque/yellow{
	dir = 1
	},
/obj/machinery/light/directional/south,
/turf/open/floor/plasteel,
/area/hangar)
"ZK" = (
/obj/structure/plasticflaps/outpost,
/obj/machinery/conveyor/auto/outpost{
	dir = 5;
	verted = -1
	},
/turf/open/floor/plasteel/tech,
/area/hangar)
"ZQ" = (
/obj/machinery/conveyor/auto/outpost,
/obj/structure/plasticflaps/outpost,
/turf/open/floor/plasteel/tech,
/area/hangar)

(1,1,1) = {"
sb
sb
sb
sb
sb
sb
sb
eH
eH
eH
eH
eH
LK
eH
eH
eH
LK
eH
eH
eH
LK
eH
eH
eH
LK
eH
eH
eH
LK
eH
eH
eH
LK
qD
qD
qD
XS
qD
qD
qD
XS
qD
qD
qD
XS
qD
qD
qD
XS
qD
qD
qD
XS
eH
eH
sb
sb
sb
sb
sb
"}
(2,1,1) = {"
sb
sb
sb
sb
sb
sb
JZ
Om
ga
TO
EH
EH
EH
EH
EH
EH
EH
EH
EH
EH
EH
EH
EH
EH
EH
EH
EH
EH
EH
EH
xD
xD
xD
xD
xD
xD
xD
xD
xD
xD
xD
xD
xD
xD
xD
xD
xD
xD
xD
xD
xD
xD
ga
TO
sb
sb
sb
sb
sb
sb
"}
(3,1,1) = {"
sb
sb
sb
sb
dL
JZ
JZ
hT
DE
jd
JB
JB
JB
JB
JB
JB
JB
JB
JB
JB
JB
JB
JB
JB
JB
JB
JB
JB
JB
JB
JB
JB
JB
JB
JB
JB
JB
JB
JB
JB
JB
JB
JB
JB
JB
JB
JB
JB
JB
JB
JB
JB
DE
jd
sb
sb
sb
sb
sb
sb
"}
(4,1,1) = {"
sb
sb
sb
sb
JZ
JZ
JZ
Om
QG
QG
JJ
JJ
JJ
dx
JJ
WY
JJ
JJ
dx
JJ
WY
JJ
JJ
dx
JJ
WY
JJ
JJ
dx
JJ
WY
JJ
JJ
dx
JJ
WY
JJ
JJ
dx
JJ
WY
JJ
JJ
dx
JJ
WY
JJ
JJ
dx
JJ
JJ
JJ
QG
QG
Hl
JZ
sb
sb
sb
sb
"}
(5,1,1) = {"
sb
sb
sb
sb
JL
JZ
JZ
Om
QG
QG
QG
Bv
VT
VT
VT
VT
VT
VT
VT
VT
VT
VT
VT
VT
VT
VT
VT
VT
VT
VT
VT
VT
VT
VT
VT
VT
VT
VT
VT
VT
VT
VT
VT
VT
VT
VT
VT
VT
VT
VT
cq
QG
QG
QG
Hl
JZ
dL
sb
sb
sb
"}
(6,1,1) = {"
sb
sb
sb
sb
sb
JZ
JZ
Om
QG
QG
uE
iZ
iZ
iZ
iZ
iZ
iZ
iZ
iZ
iZ
iZ
iZ
iZ
iZ
iZ
iZ
iZ
iZ
iZ
iZ
iZ
iZ
iZ
iZ
iZ
iZ
iZ
iZ
iZ
iZ
iZ
iZ
iZ
iZ
iZ
iZ
iZ
iZ
iZ
iZ
Um
uE
xD
QG
Hl
JZ
JZ
sb
sb
sb
"}
(7,1,1) = {"
sb
sb
sb
sb
sb
JZ
JZ
Om
QG
xD
EG
iZ
iZ
iZ
iZ
iZ
iZ
iZ
iZ
iZ
iZ
iZ
iZ
iZ
iZ
iZ
iZ
iZ
iZ
iZ
iZ
iZ
iZ
iZ
iZ
iZ
iZ
iZ
iZ
iZ
iZ
iZ
iZ
iZ
iZ
iZ
iZ
iZ
iZ
iZ
iZ
wS
xD
QG
Hl
dL
JZ
sb
sb
sb
"}
(8,1,1) = {"
sb
sb
sb
sb
sb
JZ
JZ
Om
QG
xD
EG
VV
iZ
iZ
iZ
iZ
iZ
iZ
iZ
iZ
iZ
iZ
iZ
iZ
iZ
iZ
iZ
iZ
iZ
iZ
iZ
iZ
iZ
iZ
iZ
iZ
iZ
iZ
iZ
iZ
iZ
iZ
iZ
iZ
iZ
iZ
iZ
iZ
iZ
iZ
VV
wS
xD
QG
Hl
JZ
sb
sb
sb
sb
"}
(9,1,1) = {"
sb
sb
sb
sb
sb
JZ
dL
Om
QG
xD
EG
iZ
iZ
iZ
iZ
iZ
iZ
iZ
iZ
iZ
iZ
iZ
iZ
iZ
iZ
iZ
iZ
iZ
iZ
iZ
iZ
iZ
iZ
iZ
iZ
iZ
iZ
iZ
iZ
iZ
iZ
iZ
iZ
iZ
iZ
iZ
iZ
iZ
iZ
iZ
iZ
wS
xD
QG
Hl
JL
sb
sb
sb
sb
"}
(10,1,1) = {"
sb
sb
sb
sb
sb
JZ
JZ
Om
QG
xD
EG
iZ
iZ
iZ
iZ
iZ
iZ
iZ
iZ
iZ
iZ
iZ
iZ
iZ
iZ
iZ
iZ
iZ
iZ
iZ
iZ
iZ
iZ
iZ
iZ
iZ
iZ
iZ
iZ
iZ
iZ
iZ
iZ
iZ
iZ
iZ
iZ
iZ
iZ
iZ
iZ
wS
xD
QG
Hl
JZ
sb
sb
sb
sb
"}
(11,1,1) = {"
sb
sb
sb
sb
sb
JZ
JZ
Om
QG
xD
EG
iZ
iZ
iZ
iZ
iZ
iZ
iZ
iZ
iZ
iZ
iZ
iZ
iZ
iZ
iZ
iZ
iZ
iZ
iZ
iZ
iZ
iZ
iZ
iZ
iZ
iZ
iZ
iZ
iZ
iZ
iZ
iZ
iZ
iZ
iZ
iZ
iZ
iZ
iZ
iZ
wS
xD
QG
Hl
JZ
sb
sb
sb
sb
"}
(12,1,1) = {"
sb
sb
sb
sb
sb
JZ
JZ
hT
QG
xD
EG
iZ
iZ
iZ
iZ
iZ
iZ
iZ
iZ
iZ
iZ
iZ
iZ
iZ
iZ
iZ
iZ
iZ
iZ
iZ
iZ
iZ
iZ
iZ
iZ
iZ
iZ
iZ
iZ
iZ
iZ
iZ
iZ
iZ
iZ
iZ
iZ
iZ
iZ
iZ
iZ
wS
xD
QG
Hl
JZ
JZ
sb
sb
sb
"}
(13,1,1) = {"
sb
sb
sb
sb
sb
JZ
JL
Om
QG
xD
gA
VV
iZ
iZ
iZ
iZ
iZ
iZ
iZ
iZ
iZ
iZ
iZ
iZ
iZ
iZ
iZ
iZ
iZ
iZ
iZ
iZ
iZ
iZ
iZ
iZ
iZ
iZ
iZ
iZ
iZ
iZ
iZ
iZ
iZ
iZ
iZ
iZ
iZ
iZ
VV
dS
xD
QG
Hl
dL
JZ
sb
sb
sb
"}
(14,1,1) = {"
sb
sb
sb
sb
JZ
JZ
JZ
Om
QG
xD
EG
iZ
iZ
iZ
iZ
iZ
iZ
iZ
iZ
iZ
iZ
iZ
iZ
iZ
iZ
iZ
iZ
iZ
iZ
iZ
iZ
iZ
iZ
iZ
iZ
iZ
iZ
iZ
iZ
iZ
iZ
iZ
iZ
iZ
iZ
iZ
iZ
iZ
iZ
iZ
iZ
wS
xD
QG
Hl
JZ
JZ
sb
sb
sb
"}
(15,1,1) = {"
sb
sb
sb
sb
JZ
JZ
JZ
Om
QG
xD
EG
iZ
iZ
iZ
iZ
iZ
iZ
iZ
iZ
iZ
iZ
iZ
iZ
iZ
iZ
iZ
iZ
iZ
iZ
iZ
iZ
iZ
iZ
iZ
iZ
iZ
iZ
iZ
iZ
iZ
iZ
iZ
iZ
iZ
iZ
iZ
iZ
iZ
iZ
iZ
iZ
wS
xD
QG
Hl
JZ
JZ
sb
sb
sb
"}
(16,1,1) = {"
sb
sb
sb
sb
JZ
dL
JZ
Om
QG
xD
EG
iZ
iZ
iZ
iZ
iZ
iZ
iZ
iZ
iZ
iZ
iZ
iZ
iZ
iZ
iZ
iZ
iZ
iZ
iZ
iZ
iZ
iZ
iZ
iZ
iZ
iZ
iZ
iZ
iZ
iZ
iZ
iZ
iZ
iZ
iZ
iZ
iZ
iZ
iZ
iZ
wS
xD
QG
Hl
JZ
JZ
sb
sb
sb
"}
(17,1,1) = {"
sb
sb
sb
sb
JZ
JZ
JZ
Om
QG
xD
EG
iZ
iZ
iZ
iZ
iZ
iZ
iZ
iZ
iZ
iZ
iZ
iZ
iZ
iZ
iZ
iZ
iZ
iZ
iZ
iZ
iZ
iZ
iZ
iZ
iZ
iZ
iZ
iZ
iZ
iZ
iZ
iZ
iZ
iZ
iZ
iZ
iZ
iZ
iZ
iZ
wS
xD
QG
Hl
JZ
JZ
JL
sb
sb
"}
(18,1,1) = {"
sb
sb
sb
JZ
JZ
JZ
JZ
Om
QG
xD
EG
VV
iZ
iZ
iZ
iZ
iZ
iZ
iZ
iZ
iZ
iZ
iZ
iZ
iZ
iZ
iZ
iZ
iZ
iZ
iZ
iZ
iZ
iZ
iZ
iZ
iZ
iZ
iZ
iZ
iZ
iZ
iZ
iZ
iZ
iZ
iZ
iZ
iZ
iZ
VV
wS
xD
QG
Hl
JZ
JZ
JZ
sb
sb
"}
(19,1,1) = {"
sb
sb
sb
JZ
JZ
JZ
JZ
Om
QG
xD
EG
iZ
iZ
iZ
iZ
iZ
iZ
iZ
iZ
iZ
iZ
iZ
iZ
iZ
iZ
iZ
iZ
iZ
iZ
iZ
iZ
iZ
iZ
iZ
iZ
iZ
iZ
iZ
iZ
iZ
iZ
iZ
iZ
iZ
iZ
iZ
iZ
iZ
iZ
iZ
iZ
wS
xD
QG
Hl
JZ
JZ
JZ
sb
sb
"}
(20,1,1) = {"
sb
sb
sb
dL
JZ
JZ
JZ
Om
QG
xD
EG
iZ
iZ
iZ
iZ
iZ
iZ
iZ
iZ
iZ
iZ
iZ
iZ
iZ
iZ
iZ
iZ
iZ
iZ
iZ
iZ
iZ
iZ
iZ
iZ
iZ
iZ
iZ
iZ
iZ
iZ
iZ
iZ
iZ
iZ
iZ
iZ
iZ
iZ
iZ
iZ
wS
xD
QG
Hl
JZ
JZ
dL
sb
sb
"}
(21,1,1) = {"
sb
sb
sb
JZ
JZ
JZ
dL
Om
QG
xD
EG
iZ
iZ
iZ
iZ
iZ
iZ
iZ
iZ
iZ
iZ
iZ
iZ
iZ
iZ
iZ
iZ
iZ
iZ
iZ
iZ
iZ
iZ
iZ
iZ
iZ
iZ
iZ
iZ
iZ
iZ
iZ
iZ
iZ
iZ
iZ
iZ
iZ
iZ
iZ
iZ
wS
xD
QG
Hl
JZ
JZ
JZ
sb
sb
"}
(22,1,1) = {"
sb
sb
sb
sb
JZ
JZ
JZ
Om
QG
xD
FF
iZ
iZ
iZ
iZ
iZ
iZ
iZ
iZ
iZ
iZ
iZ
iZ
iZ
iZ
iZ
iZ
iZ
iZ
iZ
iZ
iZ
iZ
iZ
iZ
iZ
iZ
iZ
iZ
iZ
iZ
iZ
iZ
iZ
iZ
iZ
iZ
iZ
iZ
iZ
iZ
FF
xD
QG
Hl
dL
JZ
JZ
sb
sb
"}
(23,1,1) = {"
sb
sb
sb
sb
JL
JZ
JZ
Om
QG
Vv
QG
VV
iZ
iZ
iZ
iZ
iZ
iZ
iZ
iZ
iZ
iZ
iZ
iZ
iZ
iZ
iZ
iZ
iZ
iZ
iZ
iZ
iZ
iZ
iZ
iZ
iZ
iZ
iZ
iZ
iZ
iZ
iZ
iZ
iZ
iZ
iZ
iZ
iZ
iZ
VV
QG
fS
QG
Hl
JZ
JZ
sb
sb
sb
"}
(24,1,1) = {"
sb
sb
sb
sb
sb
JZ
JZ
Om
QG
lT
ks
iZ
iZ
iZ
iZ
iZ
iZ
iZ
iZ
iZ
iZ
iZ
iZ
iZ
iZ
iZ
iZ
iZ
iZ
iZ
iZ
iZ
iZ
iZ
iZ
iZ
iZ
iZ
iZ
iZ
iZ
iZ
iZ
iZ
iZ
iZ
iZ
iZ
iZ
iZ
iZ
KF
xT
QG
Hl
JZ
JZ
sb
sb
sb
"}
(25,1,1) = {"
sb
sb
sb
sb
sb
JZ
JZ
Om
QG
lT
ks
iZ
iZ
iZ
iZ
iZ
iZ
iZ
iZ
iZ
iZ
iZ
iZ
iZ
iZ
iZ
iZ
iZ
iZ
iZ
iZ
iZ
iZ
iZ
iZ
iZ
iZ
iZ
iZ
iZ
iZ
iZ
iZ
iZ
iZ
iZ
iZ
iZ
iZ
iZ
iZ
KF
xT
QG
Hl
JZ
JZ
sb
sb
sb
"}
(26,1,1) = {"
sb
sb
sb
sb
sb
JZ
JZ
Om
QG
lT
ks
iZ
iZ
iZ
iZ
iZ
iZ
iZ
iZ
iZ
iZ
iZ
iZ
iZ
iZ
iZ
iZ
iZ
iZ
iZ
iZ
iZ
iZ
iZ
iZ
iZ
iZ
iZ
iZ
iZ
iZ
iZ
iZ
iZ
iZ
iZ
iZ
iZ
iZ
iZ
iZ
KF
xT
QG
Hl
JZ
JL
sb
sb
sb
"}
(27,1,1) = {"
sb
sb
sb
sb
JZ
JZ
JZ
Om
QG
lT
ks
iZ
iZ
iZ
iZ
iZ
iZ
iZ
iZ
iZ
iZ
iZ
iZ
iZ
iZ
iZ
iZ
iZ
iZ
iZ
iZ
iZ
iZ
iZ
iZ
iZ
iZ
iZ
iZ
iZ
iZ
iZ
iZ
iZ
iZ
iZ
iZ
iZ
iZ
iZ
iZ
KF
xT
QG
Hl
JZ
sb
sb
sb
sb
"}
(28,1,1) = {"
sb
sb
sb
sb
JZ
JZ
JZ
Om
QG
oQ
QG
VV
iZ
iZ
iZ
iZ
iZ
iZ
iZ
iZ
iZ
iZ
iZ
iZ
iZ
iZ
iZ
iZ
iZ
iZ
iZ
iZ
iZ
iZ
iZ
iZ
iZ
iZ
iZ
iZ
iZ
iZ
iZ
iZ
iZ
iZ
iZ
iZ
iZ
iZ
VV
QG
Nz
QG
Hl
JZ
sb
sb
sb
sb
"}
(29,1,1) = {"
sb
sb
sb
sb
JZ
JZ
dL
Om
QG
xD
uE
iZ
iZ
iZ
iZ
iZ
iZ
iZ
iZ
iZ
iZ
iZ
iZ
iZ
iZ
iZ
iZ
iZ
iZ
iZ
iZ
iZ
iZ
iZ
iZ
iZ
iZ
iZ
iZ
iZ
iZ
iZ
iZ
iZ
iZ
iZ
iZ
iZ
iZ
iZ
iZ
Ji
xD
QG
Hl
JZ
sb
sb
sb
sb
"}
(30,1,1) = {"
sb
sb
sb
JZ
JZ
JZ
JZ
Om
QG
xD
EG
iZ
iZ
iZ
iZ
iZ
iZ
iZ
iZ
iZ
iZ
iZ
iZ
iZ
iZ
iZ
iZ
iZ
iZ
iZ
iZ
iZ
iZ
iZ
iZ
iZ
iZ
iZ
iZ
iZ
iZ
iZ
iZ
iZ
iZ
iZ
iZ
iZ
iZ
iZ
iZ
wS
xD
QG
Hl
JZ
JZ
sb
sb
sb
"}
(31,1,1) = {"
sb
sb
sb
dL
JZ
JZ
JL
Om
QG
xD
EG
iZ
iZ
iZ
iZ
iZ
iZ
iZ
iZ
iZ
iZ
iZ
iZ
iZ
iZ
iZ
iZ
iZ
iZ
iZ
iZ
iZ
iZ
iZ
iZ
iZ
iZ
iZ
iZ
iZ
iZ
iZ
iZ
iZ
iZ
iZ
iZ
iZ
iZ
iZ
iZ
wS
xD
QG
Hl
JZ
JZ
sb
sb
sb
"}
(32,1,1) = {"
sb
sb
sb
JL
JZ
JZ
JZ
Om
QG
xD
EG
iZ
iZ
iZ
iZ
iZ
iZ
iZ
iZ
iZ
iZ
iZ
iZ
iZ
iZ
iZ
iZ
iZ
iZ
iZ
iZ
iZ
iZ
iZ
iZ
iZ
iZ
iZ
iZ
iZ
iZ
iZ
iZ
iZ
iZ
iZ
iZ
iZ
iZ
iZ
iZ
wS
xD
QG
Hl
JZ
JZ
sb
sb
sb
"}
(33,1,1) = {"
sb
sb
sb
sb
sb
JZ
JZ
Om
QG
xD
EG
VV
iZ
iZ
iZ
iZ
iZ
iZ
iZ
iZ
iZ
iZ
iZ
iZ
iZ
iZ
iZ
iZ
iZ
iZ
iZ
iZ
iZ
iZ
iZ
iZ
iZ
iZ
iZ
iZ
iZ
iZ
iZ
iZ
iZ
iZ
iZ
iZ
iZ
iZ
VV
wS
xD
QG
Hl
dL
JZ
JZ
sb
sb
"}
(34,1,1) = {"
sb
sb
sb
sb
sb
JZ
dL
Om
QG
xD
EG
iZ
iZ
iZ
iZ
iZ
iZ
iZ
iZ
iZ
iZ
iZ
iZ
iZ
iZ
iZ
iZ
iZ
iZ
iZ
iZ
iZ
iZ
iZ
iZ
iZ
iZ
iZ
iZ
iZ
iZ
iZ
iZ
iZ
iZ
iZ
iZ
iZ
iZ
iZ
iZ
wS
xD
QG
Hl
JZ
JZ
JZ
sb
sb
"}
(35,1,1) = {"
sb
sb
sb
sb
sb
JZ
JZ
Om
QG
xD
EG
iZ
iZ
iZ
iZ
iZ
iZ
iZ
iZ
iZ
iZ
iZ
iZ
iZ
iZ
iZ
iZ
iZ
iZ
iZ
iZ
iZ
iZ
iZ
iZ
iZ
iZ
iZ
iZ
iZ
iZ
iZ
iZ
iZ
iZ
iZ
iZ
iZ
iZ
iZ
iZ
wS
xD
QG
Hl
JZ
JZ
JZ
sb
sb
"}
(36,1,1) = {"
sb
sb
sb
sb
sb
JZ
JZ
Om
QG
xD
gA
iZ
iZ
iZ
iZ
iZ
iZ
iZ
iZ
iZ
iZ
iZ
iZ
iZ
iZ
iZ
iZ
iZ
iZ
iZ
iZ
iZ
iZ
iZ
iZ
iZ
iZ
iZ
iZ
iZ
iZ
iZ
iZ
iZ
iZ
iZ
iZ
iZ
iZ
iZ
iZ
dS
xD
QG
Hl
JZ
JZ
dL
sb
sb
"}
(37,1,1) = {"
sb
sb
sb
sb
sb
sb
JL
Om
QG
xD
EG
iZ
iZ
iZ
iZ
iZ
iZ
iZ
iZ
iZ
iZ
iZ
iZ
iZ
iZ
iZ
iZ
iZ
iZ
iZ
iZ
iZ
iZ
iZ
iZ
iZ
iZ
iZ
iZ
iZ
iZ
iZ
iZ
iZ
iZ
iZ
iZ
iZ
iZ
iZ
iZ
wS
xD
QG
Hl
JZ
JZ
sb
sb
sb
"}
(38,1,1) = {"
sb
sb
sb
sb
sb
sb
hf
fn
QG
xD
EG
VV
iZ
iZ
iZ
iZ
iZ
iZ
iZ
iZ
iZ
iZ
iZ
iZ
iZ
iZ
iZ
iZ
iZ
iZ
iZ
iZ
iZ
iZ
iZ
iZ
iZ
iZ
iZ
iZ
iZ
iZ
iZ
iZ
iZ
iZ
iZ
iZ
iZ
iZ
VV
wS
xD
QG
Hl
JZ
JZ
sb
sb
sb
"}
(39,1,1) = {"
sb
sb
sb
sb
sb
cG
Sq
Sq
QG
xD
EG
iZ
iZ
iZ
iZ
iZ
iZ
iZ
iZ
iZ
iZ
iZ
iZ
iZ
iZ
iZ
iZ
iZ
iZ
iZ
iZ
iZ
iZ
iZ
iZ
iZ
iZ
iZ
iZ
iZ
iZ
iZ
iZ
iZ
iZ
iZ
iZ
iZ
iZ
iZ
iZ
wS
xD
QG
Hl
JZ
JZ
sb
sb
sb
"}
(40,1,1) = {"
sb
sb
sb
sb
sb
eH
Ku
Li
QG
xD
EG
iZ
iZ
iZ
iZ
iZ
iZ
iZ
iZ
iZ
iZ
iZ
iZ
iZ
iZ
iZ
iZ
iZ
iZ
iZ
iZ
iZ
iZ
iZ
iZ
iZ
iZ
iZ
iZ
iZ
iZ
iZ
iZ
iZ
iZ
iZ
iZ
iZ
iZ
iZ
iZ
wS
xD
QG
Hl
JZ
JL
sb
sb
sb
"}
(41,1,1) = {"
sb
sb
sb
sb
sb
eH
vi
QG
QG
xD
EG
iZ
iZ
iZ
iZ
iZ
iZ
iZ
iZ
iZ
iZ
iZ
iZ
iZ
iZ
iZ
iZ
iZ
iZ
iZ
iZ
iZ
iZ
iZ
iZ
iZ
iZ
iZ
iZ
iZ
iZ
iZ
iZ
iZ
iZ
iZ
iZ
iZ
iZ
iZ
iZ
wS
xD
QG
fv
JZ
JZ
sb
sb
sb
"}
(42,1,1) = {"
sb
sb
sb
sb
sb
eH
vi
QG
QG
xD
EG
iZ
iZ
iZ
iZ
iZ
iZ
iZ
iZ
iZ
iZ
iZ
iZ
iZ
iZ
iZ
iZ
iZ
iZ
iZ
iZ
iZ
iZ
iZ
iZ
iZ
iZ
iZ
iZ
iZ
iZ
iZ
iZ
iZ
iZ
iZ
iZ
iZ
iZ
iZ
iZ
wS
xD
QG
Hl
JZ
sb
sb
sb
sb
"}
(43,1,1) = {"
sb
sb
eH
eH
eH
eH
vi
pL
QG
xD
EG
VV
iZ
iZ
iZ
iZ
iZ
iZ
iZ
iZ
iZ
iZ
iZ
iZ
iZ
iZ
iZ
iZ
iZ
iZ
iZ
iZ
iZ
iZ
iZ
iZ
iZ
iZ
iZ
iZ
iZ
iZ
iZ
iZ
iZ
iZ
iZ
iZ
iZ
iZ
VV
wS
xD
QG
Hl
JZ
sb
sb
sb
sb
"}
(44,1,1) = {"
sb
sb
eH
ZK
ZQ
ZQ
nV
pL
QG
xD
EG
iZ
iZ
iZ
iZ
iZ
iZ
iZ
iZ
iZ
iZ
iZ
iZ
iZ
iZ
iZ
iZ
iZ
iZ
iZ
iZ
iZ
iZ
iZ
iZ
iZ
iZ
iZ
iZ
iZ
iZ
iZ
iZ
iZ
iZ
iZ
iZ
iZ
iZ
iZ
iZ
wS
xD
QG
Hl
JZ
sb
sb
sb
sb
"}
(45,1,1) = {"
sb
sb
eH
gX
eH
eH
cG
mG
QG
xD
FF
iZ
iZ
iZ
iZ
iZ
iZ
iZ
iZ
iZ
iZ
iZ
iZ
iZ
iZ
iZ
iZ
iZ
iZ
iZ
iZ
iZ
iZ
iZ
iZ
iZ
iZ
iZ
iZ
iZ
iZ
iZ
iZ
iZ
iZ
iZ
iZ
iZ
iZ
iZ
iZ
FF
xD
QG
Hl
JZ
sb
sb
sb
sb
"}
(46,1,1) = {"
sb
sb
eH
JT
cv
eH
ch
bd
QG
QG
QG
dc
PY
PY
PY
PY
PY
PY
Wg
PY
PY
PY
PY
PY
PY
PY
PY
wz
QG
yD
yD
yD
yD
QG
dc
PY
PY
PY
PY
PY
PY
Wg
PY
PY
PY
PY
PY
PY
PY
PY
wz
QG
QG
QG
Hl
JZ
sb
sb
sb
sb
"}
(47,1,1) = {"
sb
sb
eH
eH
QM
eH
JZ
Om
ga
TO
QG
xD
xD
xD
xD
xD
xD
xD
xD
xD
xD
xD
xD
xD
xD
xD
xD
xD
oQ
Tv
Tv
Tv
Tv
Nz
xD
xD
xD
xD
xD
xD
xD
xD
xD
xD
xD
xD
xD
xD
xD
xD
xD
QG
ga
TO
Hl
JZ
JZ
sb
sb
sb
"}
(48,1,1) = {"
sb
sb
eH
aY
wD
eH
JZ
hT
DE
jd
QG
QG
QG
QG
QG
QG
QG
QG
QG
QG
QG
QG
QG
QG
QG
QG
QG
QG
QG
QG
QG
QG
QG
QG
QG
QG
QG
QG
QG
QG
QG
QG
QG
QG
QG
QG
QG
QG
QG
QG
QG
QG
DE
jd
Hl
JZ
dL
sb
sb
sb
"}
(49,1,1) = {"
sb
sb
eH
eH
eH
eH
JZ
gg
vO
vO
vO
vO
vO
vO
vO
vO
vO
vO
vO
vO
ch
vO
vO
ch
vO
sb
eH
eH
eH
yl
eH
yl
eH
eH
eH
sb
vO
ch
vO
vO
vO
vO
vO
vO
vO
vO
vO
vO
vO
vO
vO
ch
vO
vO
yW
JZ
sb
sb
sb
sb
"}
(50,1,1) = {"
sb
sb
sb
sb
sb
sb
sb
JZ
JZ
JZ
JL
JZ
JZ
JZ
dL
JZ
JZ
dL
JZ
JZ
JZ
JZ
JZ
JZ
sb
sb
eH
sX
KW
wg
hm
gc
hm
Yj
eH
sb
sb
sb
JZ
JZ
JZ
JZ
JZ
JZ
JZ
dL
JZ
JZ
JZ
JZ
JZ
JL
JZ
JZ
JZ
sb
sb
sb
sb
sb
"}
(51,1,1) = {"
sb
sb
sb
sb
sb
sb
sb
JZ
dL
sb
sb
JZ
JZ
sb
sb
sb
sb
sb
sb
sb
JL
JZ
dL
sb
sb
sb
eH
En
HC
HC
Dv
HC
HC
qq
eH
sb
sb
sb
sb
JL
dL
JZ
JZ
dL
sb
sb
sb
JZ
JZ
dL
JZ
JZ
JZ
sb
sb
sb
sb
sb
sb
sb
"}
(52,1,1) = {"
sb
sb
sb
sb
sb
sb
sb
sb
sb
sb
sb
sb
sb
sb
sb
sb
sb
sb
sb
sb
sb
sb
sb
sb
sb
sb
eH
pT
Yb
Ep
HC
wO
yQ
gP
eH
sb
sb
sb
sb
sb
sb
sb
sb
sb
sb
sb
sb
sb
sb
sb
sb
sb
sb
sb
sb
sb
sb
sb
sb
sb
"}
(53,1,1) = {"
eH
eH
eH
sb
sb
sb
eH
eH
eH
sb
sb
eH
eH
eH
sb
sb
eH
eH
eH
sb
sb
sb
eH
eH
eH
sb
eH
eH
eH
pO
ww
pO
eH
eH
eH
sb
eH
eH
eH
sb
sb
eH
eH
eH
sb
sb
sb
eH
eH
eH
sb
sb
eH
eH
eH
sb
sb
eH
eH
eH
"}
(54,1,1) = {"
eH
Fj
aM
Fj
Fj
Fj
Fj
Fj
Fj
Fj
Fj
Fj
Fj
Fj
Fj
Fj
Fj
Fj
Fj
Fj
Fj
Fj
Fj
Fj
Fj
Fj
Fj
Fj
eH
Kb
Kb
pK
eH
Fj
Fj
Fj
Fj
Fj
Fj
Fj
Fj
Fj
Fj
Fj
Fj
Fj
Fj
Fj
Fj
Fj
Fj
Fj
Fj
Fj
Fj
Fj
Fj
zi
Fj
eH
"}
(55,1,1) = {"
eH
Fj
aM
Fj
Fj
Fj
Fj
Fj
Fj
Fj
Fj
Fj
Fj
Fj
Fj
Fj
Fj
Fj
Fj
Fj
Fj
Fj
Fj
Fj
Fj
Fj
Fj
Fj
eH
Kb
Kb
Kb
eH
Fj
Fj
Fj
Fj
Fj
Fj
Fj
Fj
Fj
Fj
Fj
Fj
Fj
Fj
Fj
Fj
Fj
Fj
Fj
Fj
Fj
Fj
Fj
Fj
zi
Fj
eH
"}
(56,1,1) = {"
eH
Fj
aM
Fj
Fj
Fj
Fj
Fj
Fj
Fj
Fj
Fj
Fj
Fj
Fj
Fj
Fj
Fj
Fj
Fj
Fj
Fj
Fj
Fj
Fj
Fj
Fj
Fj
eH
Kb
Kb
Kb
eH
Fj
Fj
Fj
Fj
Fj
Fj
Fj
Fj
Fj
Fj
Fj
Fj
Fj
Fj
Fj
Fj
Fj
Fj
Fj
Fj
Fj
Fj
Fj
Fj
zi
Fj
eH
"}
(57,1,1) = {"
eH
eH
eH
sb
sb
sb
eH
eH
eH
sb
sb
eH
eH
eH
sb
sb
eH
eH
eH
sb
sb
sb
eH
eH
eH
sb
eH
eH
eH
eH
eH
eH
eH
eH
eH
sb
eH
eH
eH
sb
sb
eH
eH
eH
sb
sb
sb
eH
eH
eH
sb
sb
eH
eH
eH
sb
sb
eH
eH
eH
"}
(58,1,1) = {"
sb
sb
sb
sb
sb
sb
sb
sb
sb
sb
sb
sb
sb
sb
sb
sb
sb
sb
sb
sb
sb
sb
sb
sb
sb
sb
sb
sb
sb
sb
sb
sb
sb
sb
sb
sb
sb
sb
sb
sb
sb
sb
sb
sb
sb
sb
sb
sb
sb
sb
sb
sb
sb
sb
sb
sb
sb
sb
sb
sb
"}
(59,1,1) = {"
sb
sb
sb
sb
sb
sb
sb
sb
sb
sb
sb
sb
sb
sb
sb
sb
sb
sb
sb
sb
sb
sb
sb
sb
sb
sb
sb
sb
sb
sb
sb
sb
sb
sb
sb
sb
sb
sb
sb
sb
sb
sb
sb
sb
sb
sb
sb
sb
sb
sb
sb
sb
sb
sb
sb
sb
sb
sb
sb
sb
"}
(60,1,1) = {"
sb
sb
sb
sb
sb
sb
sb
sb
sb
sb
sb
sb
sb
sb
sb
sb
sb
sb
sb
sb
sb
sb
sb
sb
sb
sb
sb
sb
sb
sb
sb
sb
sb
sb
sb
sb
sb
sb
sb
sb
sb
sb
sb
sb
sb
sb
sb
sb
sb
sb
sb
sb
sb
sb
sb
sb
sb
sb
sb
sb
"}
